00000000000000000000000000000
0010011111101111011111100100
0010000000000000000000000100
0010000111111111111110000100
0010000000000000000000000100
0010000000000000000000000100
0011111111000000001111111100
0010000000000000000000000100
0010000000000000000000000100
0010000111111111111110000100
0010000000000000000000000100
0010000000000000000000000100
0000000000000000000000000000
0010000000000000000000000100
0000000000000000000000000000
0010000000000000000000000100
0010000000000000000000000100
0010000000000000000000000100
0010000111111111111110000100
0010000000000000000000000100
0010000000000000000000000100
0011111111000000001111111100
0010000000000000000000000100
0010000000000000000000000100
0010000111111111111110000100
0010000000000000000000000100
0010011111101111011111100100
0000000000000000000000000000


