0000000000010000000000010000
0000000000010000000000010000
0000010000011111111000010000
0010010000000000001000010000
0010010000000000001000010000
0010010000000111111001110000
0010000000000100000001000000
0010000000000100000001001100
0010010000000111110001001100
0000010000000000010000001100
0000010000000000011100001100
0000010000000000000100001100
0000010000000000000100000000
0010010000000000000111110000
0010000000000000000000000000
0010000000000000000111110000
0010010000000000000100000110
0010010010000000000100000000
0010010010000000000111110000
0000010011110010000000010000
0000010000010010000000010000
0010010010010010000010010000
0010010010000010000010010000
0010000010011110000010010000
0011111110010000000010000000
0000000000010011111110001100
0000000000000000000000000000
